0 0 0 0 0 0
0 1 0 3 0 1
2 9 1 2 1 2
8 7 1 3 4 3
1 0 2 2 7 7
0 1 0 0 1 0
0 0 0 0 0 0